[

  { "a": 1, "b": "2" },
  { "a": 2, "b": "4" },
  { "a": 3, "b": "6" },
  { "a": 4, "b": "8" },
  { "a": 5, "b": "10" }
]
